3 13 31
###############################
#p   x* ** 2  **#*   2  #     #
# # ##*# # # # # # # # # # #  #
#*   *  ** * *  *1  * **   *  #
# # # # # #*# # # # # # #*# # #
#*   *s*    *** *   ** 1    2 #
# # # # # # # # # # # # # #*# #
#    *  2  *    1   *    **   #
# #*# # #*#*#*#*# # # # # #*# #
#  1     *   * *    *   * 3   #
#*# # # # # # # # # # #*# # #*#
# *    * **  2 ** **#4    x   #
###############################

