2 13 31
###############################
#p * *        *  *1 * *      *#
# # #f# #*# # #*# # # # # #*# #
#x   * * **1 **      *    **  #
# #*# # # # # # #b# # # # # #*#
#          *  #  ** 1    *  **#
# # #*# # # # # #*#*#*#*# # # #
#   *   #    * 2 * * * *  2   #
# # # # #*# # # # # # #*# #*# #
#   ****s #      *     x   5  #
# # # # # # # # # #*# # # # #*#
#  ** *   *     *   3  *      #
###############################

